                                      
                                      
                                      
    ##################################
    ##################################
    ##                              ##
    ##    ##    ##      ##     ##   ##
    ##    ##    ##      ##     ##   ##
    ##                              ##
    ##S                      N      #E
    ##                              ##
    ##    ##    ##      ##   T ##   ##
    ##    ##    ##      ##     ##   ##
    ##                              ##
    ##################################
    ##################################
